11111111111
1P000000011
101100101C1
1E110001111
11111111111