11111111111
1P000000011
101100101C1
1E110001111
10CCCCCCCC1
11111111111