111111
1C0C01
1011C1
1E1P01
111111
