111111111111111111111111111111111111111111
1ECCCCCCCCCCCCCCCCCCCCCCCCCCCCCCCCCCCCCCC1
1C1111C1111C11C1111C1111C11C1111C1111C11C1
1C1111C1111C11C1111C1111C11C1111C1111C11C1
1C1111C1111C11C1111C1111C11C1111C1111C11C1
1C1111C1111C11C1111C1111C11C1111C1111C11C1
1C1111C1111C11C1111C1111C11C1111C1111C11C1
1C1111C1111C11C1111C1111C11C1111C1111C11C1
1C1111C1111C11C1111C1111C11C1111C1111C11C1
1C1111C1111C11C1111C1111C11C1111C1111C11C1
1CCCCCCCCCCCCCCCCCCCCCCCCCCCCCCCCCCCCCCCC1
1C1111C1111C11C1111C1111C11C1111C1111C11C1
1C1111C1111C11C1111C1111C11C1111C1111C11C1
1C1111C1111C11C1111C1111C11C1111C1111C11C1
1C1111C1111C11C1111C1111C11C1111C1111C11C1
1C1111C1111C11C1111C1111C11C1111C1111C11C1
1C1111C1111C11C1111C1111C11C1111C1111C11C1
1C1111C1111C11C1111C1111C11C1111C1111C11C1
1C1111C1111C11C1111C1111C11C1111C1111C11C1
1CCCCCCCCCCCCCCCCCCCCCCCCCCCCCCCCCCCCCCCP1
111111111111111111111111111111111111111111