111111111111111111111111111111111111111
1CCCCCCCCCCC11CCCCCCCCCCCCCCCCCCCCCCCC1
1C1111C1111C11C1111C1111C1C1111111111C1
1C1111C1111C11C1111C1111C1CCCCCCCCCC1C1
1C1111C1111C11C1111C1111C11111111111111
1CCCCCCCCCCCCCCCCCCCCCCCCCCCCCCCCCCCCC1
1C1111C1C11111111C1C1111C111111111111C1
1CCCCCC1CCCC11CCCC1CCCCCC1CCCCCCCCCCCC1
111111C1111C11C1111C111111C1111111111C1
111111C1CCCCCCCCCC1C111111CCCCCCCCCC1C1
111111C1C111CC111C1C11111111111111111C1
1ECCCCCCC1CCCCCC1CCCCCCCCCCCCCCCCCCCCC1
111111C1C11111111C1C111111C111111111111
111111C1CCCCCCCCCC1C111111C11111111C111
111111C1C11111111C1C111111CCCCCCCCCC111
1CCCCCCCCCCC11CCCCCCCCCCC1C11111111C111
1C1111C1111C11C1111C1111C1C111111111111
1CCC11CCCCCCCPCCCCCC11CCCCCCCCCCCCCCCC1
111111111111111111111111111111111111111