11111111111111111111111111
1CCCCCCCCCCC11CCCCCCCCCCC1
1C1111C1111C11C1111C1111C1
1C1111C1111C11C1111C1111C1
1C1111C1111C11C1111C1111C1
1CCCCCCCCCCCCCCCCCCCCCCCC1
1C1111C1C11111111C1C1111C1
1CCCCCC1CCCC11CCCC1CCCCCC1
111111C1111C11C1111C111111
111111C1CCCCCCCCCC1C111111
111111C1C111CC111C1C111111
1ECCCCCCC1CCCCCC1CCCCCCCC1
111111C1C11111111C1C111111
111111C1CCCCCCCCCC1C111111
111111C1C11111111C1C111111
1CCCCCCCCCCC11CCCCCCCCCCC1
1C1111C1111C11C1111C1111C1
1CCC11CCCCCCCPCCCCCC11CCC1
11111111111111111111111111